0011010010
0000100111
0001100101
1010101001
0000111110
1010001100
1010100110
1010001011
0001010110
0001011000
