605040070
002000060
007800032
406390000
080020090
000054206
370005600
050000800
999999999